1`1`10`2`2;
2`2`10`2`2;
3`3`10`2`2;
4`4`10`2`2;
5`5`10`2`2;
6`6`10`2`2;
7`7`10`2`2;
8`8`10`2`2;
9`9`10`2`2;
10`10`10`2`2;